1 1 1 1 1 1 1 1 1 1 1 1 1 1 1 1
1 0 1 1 6 0 1 1 0 0 0 0 0 0 0 1
1 0 1 0 0 1 0 0 1 0 0 0 0 0 3 1
1 0 0 9 5 1 0 0 1 9 0 0 0 0 0 1
1 0 0 1 7 0 1 1 0 0 0 0 0 0 0 1
1 7 0 1 0 0 0 0 1 1 0 0 0 6 0 1
1 0 0 0 0 0 0 9 0 0 0 0 0 0 0 1
1 0 2 0 0 0 0 0 0 0 0 6 0 0 0 1
1 1 1 1 1 1 1 0 0 1 1 1 1 1 1 1
1 1 1 1 1 1 1 0 0 1 1 1 1 1 1 1
1 0 1 1 6 0 1 1 0 0 0 0 0 0 0 1
1 0 1 0 0 1 0 0 1 0 0 0 0 0 3 1
1 0 0 9 5 1 0 0 1 9 0 0 0 0 0 1
1 0 0 1 7 0 1 1 0 0 0 0 0 0 0 1
1 7 0 1 0 0 0 0 1 1 0 0 0 6 0 1
1 0 0 0 0 0 0 9 0 0 0 0 0 0 0 1
1 0 0 0 0 0 0 0 0 0 0 0 0 0 5 1
1 0 0 0 0 0 0 0 0 0 0 6 0 0 0 1
1 0 0 0 0 0 0 0 0 0 0 0 0 0 0 1
1 1 1 1 1 1 1 1 1 1 1 1 1 1 1 1